{ 
    "height": 15,
    "width": 25,
    "tile_size": 32,
    "tiles":[
            [1, 1, 1, 1, 1, 1, 1, 1, 1, 1, 1, 1, 1, 1, 1, 1, 1, 1, 1, 1, 1, 1, 1, 1, 1],
            [1, 8, 8, 8, 2, 0, 0, 0, 0, 0, 0, 0, 0, 0, 0, 0, 2, 0, 0, 0, 2, 0, 0, 0, 1],
            [1, 8, 8, 8, 2, 0, 7, 7, 7, 7, 7, 7, 7, 0, 0, 0, 2, 0, 0, 0, 0, 0, 0, 0, 1],
            [1, 0, 0, 0, 2, 0, 7, 0, 0, 0, 0, 0, 7, 0, 0, 0, 0, 0, 7, 7, 7, 7, 7, 0, 1],
            [1, 0, 0, 0, 2, 0, 7, 0, 4, 0, 0, 0, 7, 0, 0, 0, 0, 0, 7, 0, 0, 0, 7, 0, 1],
            [1, 0, 0, 0, 4, 0, 7, 0, 4, 0, 0, 0, 7, 0, 0, 0, 0, 0, 7, 0, 2, 0, 7, 0, 1],
            [1, 0, 7, 0, 5, 0, 7, 0, 4, 0, 0, 0, 7, 0, 0, 0, 2, 0, 7, 0, 2, 0, 7, 0, 1],
            [1, 0, 7, 0, 4, 0, 7, 0, 2, 0, 0, 0, 7, 0, 0, 0, 2, 0, 7, 0, 4, 0, 7, 0, 1],
            [1, 0, 7, 0, 2, 0, 7, 0, 2, 0, 0, 0, 7, 0, 0, 0, 4, 0, 7, 0, 5, 0, 7, 0, 1],
            [1, 0, 7, 0, 2, 0, 7, 0, 0, 0, 0, 0, 7, 0, 0, 0, 4, 0, 7, 0, 4, 0, 0, 0, 1],
            [1, 0, 7, 0, 0, 0, 7, 0, 0, 0, 0, 0, 7, 0, 0, 0, 4, 0, 7, 0, 2, 0, 0, 0, 1],
            [1, 0, 7, 7, 7, 7, 7, 0, 0, 0, 0, 0, 7, 0, 0, 0, 0, 0, 7, 0, 2, 0, 0, 0, 1],
            [1, 0, 0, 0, 0, 0, 0, 0, 2, 0, 0, 0, 7, 7, 7, 7, 7, 7, 7, 0, 2, 9, 9, 9, 1],
            [1, 0, 0, 0, 2, 0, 0, 0, 2, 0, 0, 0, 0, 0, 0, 0, 0, 0, 0, 0, 2, 9, 9, 9, 1],
            [1, 1, 1, 1, 1, 1, 1, 1, 1, 1, 1, 1, 1, 1, 1, 1, 1, 1, 1, 1, 1, 1, 1, 1, 1]
    ],
    "spawn_points":{
            "player_1": [ 1,  3, [0,  1]],
            "player_2": [13, 21, [0, -1]],
            "player_3": [ 1,  1, [0,  1]],
            "player_4": [13, 23, [0, -1]]
    },
    "objectives":{
        "cart": { 
                "path": [
                        [ 6,  2], [11,  2], [11,  6], [ 2,  6], [ 2, 12], 
                        [ 7, 12],
                        [12, 12], [12, 18], [ 3, 18], [ 3, 22], [ 8, 22]
                ],
                "start": 5,
                "region_radius": 2
        }
    }
}
