{ 
    "height": 15,
    "width": 25,
    "tile_size": 32,
    "tiles":[
            [4, 4, 4, 4, 4, 4, 4, 4, 4, 4, 4, 4, 4, 4, 4, 4, 4, 4, 4, 4, 4, 4, 4, 4, 4],
            [3,15, 0, 5, 2, 0, 0, 0, 0, 0, 0, 0, 0, 0, 0, 0, 2, 0, 0, 0, 2, 0, 0, 0, 3],
            [3, 0, 0, 0, 2, 0, 7, 7, 7, 7, 7, 7, 7, 0, 0, 0, 2, 0, 0, 0, 0, 0, 0, 0, 3],
            [3, 0, 0, 0, 2, 0, 7, 0, 0, 0, 0, 0, 7, 0, 0, 0, 0, 0, 7, 7, 7, 7, 7, 0, 3],
            [3, 0, 0, 0, 2, 0, 7, 0, 1, 0, 0, 0, 7, 0, 0, 0, 0, 0, 7, 0, 0, 0, 7, 0, 3],
            [3, 0, 0, 0, 1, 0, 7, 0, 1, 0, 0, 0, 7, 0, 0, 0, 0, 0, 7, 0, 2, 0, 7, 0, 3],
            [3, 0, 8, 0, 1, 0, 7, 0, 1, 0, 0, 0, 7, 0, 0, 0, 2, 0, 7, 0, 2, 0, 7, 0, 3],
            [3, 0, 7, 0, 1, 0, 7, 0, 2, 0, 0, 0, 7, 0, 0, 0, 2, 0, 7, 0, 1, 0, 7, 0, 3],
            [3, 0, 7, 0, 2, 0, 7, 0, 2, 0, 0, 0, 7, 0, 0, 0, 1, 0, 7, 0, 1, 0, 8, 0, 3],
            [3, 0, 7, 0, 2, 0, 7, 0, 0, 0, 0, 0, 7, 0, 0, 0, 1, 0, 7, 0, 1, 0, 0, 0, 3],
            [3, 0, 7, 0, 0, 0, 7, 0, 0, 0, 0, 0, 7, 0, 0, 0, 1, 0, 7, 0, 2, 0, 0, 0, 3],
            [3, 0, 7, 7, 7, 7, 7, 0, 0, 0, 0, 0, 7, 0, 0, 0, 0, 0, 7, 0, 2, 0, 0, 0, 3],
            [3, 0, 0, 0, 0, 0, 0, 0, 2, 0, 0, 0, 7, 7, 7, 7, 7, 7, 7, 0, 2, 0, 0, 0, 3],
            [3, 0, 0, 0, 2, 0, 0, 0, 2, 0, 0, 0, 0, 0, 0, 0, 0, 0, 0, 0, 2,10, 0,20, 3],
            [3, 4, 4, 4, 4, 4, 4, 4, 4, 4, 4, 4, 4, 4, 4, 4, 4, 4, 4, 4, 4, 4, 4, 4, 3]
    ],
    "spawn_points":{
            "player_1": [ 1,  3],
            "player_2": [13, 21],
            "player_3": [ 1,  1],
            "player_4": [13, 23]
    },
    "objectives":{
        "cart": { 
                "points": [
                        [ 7,  2], [11,  2], [11,  6], [ 2,  6], [ 2, 12], 
                        [ 7, 12],
                        [12, 12], [12, 18], [ 3, 18], [ 3, 22], [ 8, 22]
                ],
                "start": {"row": 7, "column": 12, "point_idx": 6},
                "region_radius": 128
        }
    }
}
