{ 
    "height": 15,
    "width": 25,
    "tile_size": 32,
    "tiles":[
            [4, 4, 4, 4, 4, 4, 4, 4, 4, 4, 4, 4, 4, 4, 4, 4, 4, 4, 4, 4, 4, 4, 4, 4, 4],
            [3, 0, 0, 5, 1, 0, 2, 0, 0, 0, 0, 0, 1, 0, 0, 0, 0, 0, 2, 0, 1,20, 0, 0, 3],
            [3, 0, 2, 2, 2, 0, 2, 0, 1, 1, 0, 1, 1, 1, 0, 1, 1, 0, 2, 0, 2, 2, 2, 0, 3],
            [3, 0, 2, 0, 0, 0, 2, 0, 0, 1, 0, 0, 0, 0, 0, 1, 0, 0, 2, 0, 0, 0, 2, 0, 3],
            [3, 0, 2, 0, 0, 0, 0, 0, 0, 2, 2, 0, 0, 0, 2, 2, 0, 0, 0, 0, 0, 0, 2, 0, 3],
            [3, 0, 0, 0, 1, 0, 0, 0, 0, 2, 0, 0, 0, 0, 0, 2, 0, 0, 0, 0, 1, 0, 0, 0, 3],
            [3, 0, 0, 0, 1, 0, 0, 0, 0, 0, 0, 0, 0, 0, 0, 0, 0, 0, 0, 0, 1, 0, 0, 0, 3],
            [3, 0, 0, 0, 1, 1, 0, 0, 0, 0, 0, 0, 0, 0, 0, 0, 0, 0, 0, 1, 1, 0, 0, 0, 3],
            [3, 0, 0, 0, 1, 0, 0, 0, 0, 0, 0, 0, 0, 0, 0, 0, 0, 0, 0, 0, 1, 0, 0, 0, 3],
            [3, 0, 0, 0, 1, 0, 0, 0, 0, 2, 0, 0, 0, 0, 0, 2, 0, 0, 0, 0, 1, 0, 0, 0, 3],
            [3, 0, 2, 0, 0, 0, 0, 0, 0, 2, 2, 0, 0, 0, 2, 2, 0, 0, 0, 0, 0, 0, 2, 0, 3],
            [3, 0, 2, 0, 0, 0, 2, 0, 0, 1, 0, 0, 0, 0, 0, 1, 0, 0, 2, 0, 0, 0, 2, 0, 3],
            [3, 0, 2, 2, 2, 0, 2, 0, 1, 1, 0, 1, 1, 1, 0, 1, 1, 0, 2, 0, 2, 2, 2, 0, 3],
            [3, 0, 0,15, 1, 0, 2, 0, 0, 0, 0, 0, 1, 0, 0, 0, 0, 0, 2, 0, 1,10, 0, 0, 3],
            [3, 4, 4, 4, 4, 4, 4, 4, 4, 4, 4, 4, 4, 4, 4, 4, 4, 4, 4, 4, 4, 4, 4, 4, 3]
    ],
    "spawn_points":{
            "player_1": [ 1,  3, [1, 0]],
            "player_2": [13, 21, [1, 0]],
            "player_3": [13,  3, [1, 0]],
            "player_4": [ 1, 21, [1, 0]]
    },
    "objectives": {
        "flags": {
            "team_1": {"row": 7, "column":  2, "radius": 6},
            "team_2": {"row": 7, "column": 22, "radius": 6}
        },
        "capture_points": {
            "team_1": {"row": 7, "column":  2, "radius": 72},
            "team_2": {"row": 7, "column": 22, "radius": 72}
        }
    }
}