{ 
    "height": 15,
    "width": 25,
    "tile_size": 32,
    "tiles":[
            [1, 1, 1, 1, 1, 1, 1, 1, 1, 1, 1, 1, 1, 1, 1, 1, 1, 1, 1, 1, 1, 1, 1, 1, 1],
            [1, 0, 0, 0, 0, 0, 4, 0, 0, 0, 0, 0, 2, 0, 0, 0, 0, 0, 4, 0, 0, 0, 0, 0, 1],
            [1, 0, 0, 0, 0, 0, 5, 0, 0, 0, 0, 0, 0, 0, 0, 0, 0, 0, 5, 0, 0, 0, 0, 0, 1],
            [1, 0, 2, 2, 0, 0, 0, 0, 0, 0, 2, 0, 0, 0, 2, 0, 0, 0, 0, 0, 0, 2, 2, 0, 1],
            [1, 0, 2, 0, 0, 0, 0, 0, 0, 2, 2, 4, 4, 4, 2, 2, 0, 0, 0, 0, 0, 0, 2, 0, 1],
            [1, 8, 2, 0, 0, 0, 3, 0, 0, 0, 0, 0, 0, 0, 0, 0, 0, 0, 3, 0, 0, 0, 2, 9, 1],
            [1, 8, 8, 0, 0, 0, 6, 0, 6, 0, 0, 0, 0, 0, 0, 0, 6, 0, 6, 0, 0, 0, 9, 9, 1],
            [1, 8, 8, 0, 0, 5, 5, 0, 5, 0, 0, 0, 0, 0, 0, 0, 5, 0, 5, 5, 0, 0, 9, 9, 1],
            [1, 8, 8, 0, 0, 0, 6, 0, 6, 0, 0, 0, 0, 0, 0, 0, 6, 0, 6, 0, 0, 0, 9, 9, 1],
            [1, 8, 2, 0, 0, 0, 3, 0, 0, 0, 0, 0, 0, 0, 0, 0, 0, 0, 3, 0, 0, 0, 2, 9, 1],
            [1, 0, 2, 0, 0, 0, 0, 0, 0, 2, 0, 0, 0, 0, 0, 2, 0, 0, 0, 0, 0, 0, 2, 0, 1],
            [1, 0, 2, 2, 0, 0, 0, 0, 0, 2, 2, 0, 0, 0, 2, 2, 0, 0, 0, 0, 0, 2, 2, 0, 1],
            [1, 0, 0, 0, 0, 0, 5, 0, 0, 0, 2, 0, 0, 0, 2, 0, 0, 0, 5, 0, 0, 0, 0, 0, 1],
            [1, 0, 0, 0, 0, 0, 4, 0, 0, 0, 0, 0, 0, 0, 0, 0, 0, 0, 4, 0, 0, 0, 0, 0, 1],
            [1, 1, 1, 1, 1, 1, 1, 1, 1, 1, 1, 1, 1, 1, 1, 1, 1, 1, 1, 1, 1, 1, 1, 1, 1]
    ],
    "spawn_points":{
            "player_1": [ 6,  1, [1, 0]],
            "player_2": [ 8, 23, [1, 0]],
            "player_3": [ 8,  1, [1, 0]],
            "player_4": [ 6, 23, [1, 0]]
    },
    "objectives":{
            "zone": {"row": 7, "column": 12, "radius":96}
    }
}
